{
    "contours": [
        [
        {"x": 0, "y": 5},
        {"x": 0, "y": 1},
        {"x": 2, "y": 1},
        {"x": 2, "y": 0},
        {"x": 5, "y": 0},
        {"x": 7, "y": 2},
        {"x": 7, "y": 4},
        {"x": 9, "y": 2},
        {"x": 9, "y": 4},
        {"x": 10, "y": 3},
        {"x": 10, "y": 6},
        {"x": 6, "y": 7},
        {"x": 6, "y": 6},
        {"x": 5, "y": 6},
        {"x": 5, "y": 7},
        {"x": 4, "y": 7},
        {"x": 4, "y": 4},
        {"x": 5, "y": 4},
        {"x": 5, "y": 5},
        {"x": 6, "y": 5},
        {"x": 6, "y": 3},
        {"x": 3, "y": 3},
        {"x": 3, "y": 7},
        {"x": 2, "y": 7},
        {"x": 2, "y": 8},
        {"x": 3, "y": 8},
        {"x": 3, "y": 9},
        {"x": 0, "y": 9},
        {"x": 0, "y": 8},
        {"x": 1, "y": 8},
        {"x": 1, "y": 7}
        ]
    ]
}