{
    "contours": [
        [
            {"x": 2, "y": 0},
            {"x": 2, "y": 4},
            {"x": 5, "y": 4},
            {"x": 5, "y": 3},
            {"x": 3, "y": 3},
            {"x": 3, "y": 1},
            {"x": 9, "y": 1},
            {"x": 9, "y": 3},
            {"x": 7, "y": 3},
            {"x": 7, "y": 4},
            {"x": 11, "y": 4},
            {"x": 11, "y": 6},
            {"x": 7, "y": 6},
            {"x": 7, "y": 7},
            {"x": 9, "y": 7},
            {"x": 9, "y": 9},
            {"x": 3, "y": 9},
            {"x": 3, "y": 7},
            {"x": 5, "y": 7},
            {"x": 5, "y": 6},
            {"x": 0, "y": 6},
            {"x": 0, "y": 0}
        ]
    ]
}