{
    "contours": [
        [
            {"x": 20, "y": 0},
            {"x": 20, "y": 40},
            {"x": 50, "y": 40},
            {"x": 50, "y": 30},
            {"x": 30, "y": 30},
            {"x": 30, "y": 10},
            {"x": 90, "y": 10},
            {"x": 90, "y": 30},
            {"x": 70, "y": 30},
            {"x": 70, "y": 40},
            {"x": 110, "y": 40},
            {"x": 110, "y": 60},
            {"x": 70, "y": 60},
            {"x": 70, "y": 70},
            {"x": 90, "y": 70},
            {"x": 90, "y": 90},
            {"x": 30, "y": 90},
            {"x": 30, "y": 70},
            {"x": 50, "y": 70},
            {"x": 50, "y": 60},
            {"x": 0, "y": 60},
            {"x": 0, "y": 0}
        ]
    ]
}